#############################################################################
#############################################################################
###   #               #               #           #                   #   ###
###   #   #########   #   #####   #########   #####   #####   #####   #   ###
###               #       #   #           #           #   #   #       #   ###
###########   #   #########   #########   #####   #   #   #   #########   ###
###       #   #               #           #   #   #   #   #           #   ###
###   #   #############   #   #   #########   #####   #   #########   #   ###
###   #               #   #   #       #           #           #       #   ###
###   #############   #####   #####   #   #####   #########   #   #####   ###
###           #       #   #       #   #       #           #   #           ###
###   #####   #####   #   #####   #   #########   #   #   #   ###############
###       #       #   #   #       #       #       #   #   #       #       ###
###############   #   #   #   #########   #   #####   #   #####   #####   ###
###           #   #           #       #   #       #   #       #           ###
###   #####   #   #########   #####   #   #####   #####   #############   ###
###   #       #           #           #       #   #   #               #   ###
###   #   #########   #   #####   #########   #   #   #############   #   ###
###   #           #   #   #   #   #           #               #   #       ###
###   #########   #   #   #   #####   #########   #########   #   ###########
###   #       #   #   #           #           #   #       #               ###
###   #   #####   #####   #####   #########   #####   #   #########   #   ###
###   #                   #           #               #               #   ###
###   #####   #   #########   #####   #   #####   #####   #############   ###
###   #       #           #           #       #   #   #               #   ###
###   #   #########   #   #####   #########   #   #   #############   #   ###
###   #           #   #   #   #   #           #               #   #       ###
###   #########   #   #   #   #####   #########   #########   #   ###########
###   #       #   #   #           #           #   #       #               ###
###   #   #####   #####   #####   #########   #####   #   #########   #   ###
###   #                   #           #               #               #   ###
###   #######################################################################
###XXX#######################################################################