#############################################
#############################################
##### #       #       #     #         # #####
##### # ##### # ### ##### ### ### ### # #####
#####       #   # #     #     # # #   # #####
######### # ##### ##### ### # # # ##### #####
#####   # #       #     # # # # #     # #####
##### # ####### # # ##### ### # ##### # #####
##### #       # # #   #     #     #   # #####
##### ####### ### ### # ### ##### # ### #####
#####     #   # #   # #   #     # #     #####
##### ### ### # ### # ##### # # # ###########
#####   #   # # #   #   #   # # #   #   #####
########### # # # ##### # ### # ### ### #####
#####     # #     #   # #   # #   #     #####
##### ### # ##### ### # ### ### ####### #####
##### #   #     #     #   # # #       # #####
##### # ##### # ### ##### # # ####### # #####
##### #     # # # # #     #       # #   #####
##### ##### # # # ### ##### ##### # #########
##### #   # # #     #     # #   #       #####
##### # ### ### ### ##### ### # ##### # #####
##### #         #     #       #       # #####
##### #######################################
#####X#######################################