#############################################################################
#############################################################################
###   #               #               #           #                   #     X
###   #   #########   #   #####   #########   #####   #####   #####   #   ###
###               #       #   #           #           #   #   #       #   ###
###########   #   #########   #########   #####   #   #   #   #########   ###
###       #   #               #           #   #   #   #   #           #   ###
###   #   #############   #   #   #########   #####   #   #########   #   ###
###   #               #   #   #       #           #           #       #   ###
###   #############   #####   #####   #   #####   #########   #   #####   ###
###           #       #   #       #   #       #           #   #           ###
###   #####   #####   #   #####   #   #########   #   #   #   ###############
###       #       #   #   #       #       #       #   #   #       #       ###
###############   #   #   #   #########   #   #####   #   #####   #####   ###
##            #   #           #       #   #       #   #       #           ###
## ## #####   #   #########   #####   #   #####   #####   #############   ###
## ## #       #           #           #       #   #   #               #   ###
## ## #   #########   #   #####   #########   #   #   #############   #   ###
##    #           #   #   #   #   #           #               #   #       ###
###############   #   #   #   #####   #########   #########   #   ###########
#######       #   #   #           #           #   #       #               ###
#######   #####   #####   #####   #########   #####   #   #########   #   ###
#######                   #           #               #               #   ###
#############################################################################
#############################################################################